bbbbbbbbbbbbbbbb
bs.............b
b..............b
b..............b
bH.............b
b..............b
bbbbbbb........b
bbbbbbb........b
b..............b
b.....H........b
b..............b
b.......bbbbbbbb
b........f..b..b
bbbbbbbbbbb.b..b
b.........bfb..b
b.........b.b..b
b.......bbb.b..b
b.......bbbfbbbb
b.......bbb...bb
bbbbbbbbbbbbbXbb
