bbbbbbbbbbbbbbbb
bs..f..........b
b...f..........b
b.....bbbbbbbbbb
b.......f......b
b.....bbbbbbbbbb
b..............b
b..............b
b..f..f..f.....b
b..............b
b....H.........b
b.....bbbbbbbbbb
b...........b..b
bbbbbbbbbbb.b..b
b.........b.b..b
b.........b.b..b
b.......bbb.b..b
b.......bbf.bbbb
b.......bbb...fb
bbbbbbbbbbbbbXbb
