bbbbbbbbbb
bs..f....b
b...f....b
b.....bbbb
b.......fb
b.....bbbb
b........b
b........b
b........b
b........b
b........b
b.....bbbb
b........b
b.....bbbb
b........b
b........b
b........b
b........b
b........b
bbbbbbbbbb
