bbbbbbbbbbbbbbbb
bs..f..........b
b...f..........b
b....bbbbbb....b
b....b..f.b....b
b....bbbbbb....b
b....b....b....b
b....bbbbbb....b
b..f..f..f.....b
b..............b
b....H.........b
b.....bbbbbbb..b
b...........b..b
b.....bbbbb.b..b
b.........b.b..b
b.........b.b..b
b..............b
b..............b
b..............b
bbbbbbbbbbbbbXbb
