bbbbbbbbbbbbbbbb
bs.............b
bf.............b
bf.............b
bf.............b
bf....bb.bbbbbbb
b.....bb.bb....b
b.....bb.bb....b
b.....bb.bb....b
b..bbbbbbbbbbbbb
b..b.b.b.bVb...b
b.bb.b.bVb.bbb.b
b.bb.bVb.b.bbb.b
b.bbVb.b.b.bbb.b
b..............b
bbbbbbbbbbbbb..b
b.b....bbbbbb..b
b.......bb..b..b
b..............b
bbbbbbbbbbbbbXbb
