bbbbbbbbbbbbbbbb
bs..f..........b
b...f..........b
b..............b
b..............b
b..............b
b..............b
b..............b
b..f..f..f.....b
b..............b
b....H.........b
b..............b
b.....bbb......b
b.......b..bbbbb
b.......bbbb...b
b......Vbbbbbbbb
b.......bbbbbbbb
b.....V....b...b
b........b...b.b
bbbbbbbbbbbbbbXb
